"aa" = (/turf/grass,/area/dark)
"ab" = (/turf/GrassWaterSE2,/area/dark)
"ac" = (/turf/GrassWaterW,/area/dark)
"ad" = (/turf/GrassWaterSW2,/area/dark)
"ae" = (/turf/GrassWaterE,/area/dark)
"af" = (/turf/Water,/area/dark)
"ag" = (/turf/GrassWaterS,/area/dark)
"ah" = (/turf/CliffT,/area/dark)
"ai" = (/turf/TreetopNW,/area/dark)
"aj" = (/turf/Tree2topN,/area/dark)
"ak" = (/turf/TreetopNE,/area/dark)
"al" = (/turf/CliffM,/area/dark)
"am" = (/turf/Tree2topW,/area/dark)
"an" = (/turf/Treecenter2,/area/dark)
"ao" = (/turf/Tree2topE,/area/dark)
"ap" = (/turf/CliffB,/area/dark)
"aq" = (/turf/TreetopSW,/area/dark)
"ar" = (/turf/Tree2topS,/area/dark)
"as" = (/turf/TreetopSE,/area/dark)
"at" = (/obj/torchlit,/turf/grass,/area/dark)
"au" = (/turf/Treestump2,/area/dark)
"av" = (/turf/Tree2topNW,/area/dark)
"aw" = (/turf/TreetopN,/area/dark)
"ax" = (/turf/GrassWaterNW,/area/dark)
"ay" = (/turf/GrassWaterN,/area/dark)
"az" = (/turf/GrassWaterNW2,/area/dark)
"aA" = (/turf/TreetopW,/area/dark)
"aB" = (/turf/Treecenter1,/area/dark)
"aC" = (/turf/TreetopE,/area/dark)
"aD" = (/turf/Tree2topSW,/area/dark)
"aE" = (/turf/Tree2topSE,/area/dark)
"aF" = (/turf/GrassWaterNE2,/area/dark)
"aG" = (/turf/TreetopS,/area/dark)
"aH" = (/turf/Treestump1,/area/dark)
"aI" = (/turf/Grassflower2,/area/dark)
"aJ" = (/turf/Bush1,/area/dark)
"aK" = (/turf/grass,/area)
"aL" = (/turf/Treestump,/area/dark)
"aM" = (/turf/Bush2,/area/dark)
"aN" = (/turf/Bush3,/area/dark)
"aO" = (/turf/Start,/area/dark)
"aP" = (/turf/DirtgrassNW,/area/dark)
"aQ" = (/turf/DirtgrassN,/area/dark)
"aR" = (/turf/DirtgrassNE,/area/dark)
"aS" = (/turf/DirtgrassS,/area/dark)
"aT" = (/turf/DirtWaterSE2,/area/dark)
"aU" = (/turf/DirtWaterSW2,/area/dark)
"aV" = (/turf/DirtgrassE,/area/dark)
"aW" = (/turf/Cavewall,/area/dark)
"aX" = (/turf/Grassflower1,/area/dark)
"aY" = (/turf/DirtWaterNE2,/area/dark)
"aZ" = (/turf/DirtWaterNW2,/area/dark)
"ba" = (/turf/DirtgrassSW,/area/dark)
"bb" = (/turf/DirtgrassW,/area/dark)
"bc" = (/turf/DirtgrassSE,/area/dark)
"bd" = (/turf/Cavefloor,/area/dark)

(1,1,1) = {"
aaaaaaaaaaaaaaaaaaaaaaaaaaaaaaaaaaaaaaaaaaaaaaaaaaaaaaaaaaaa
aaaaaaaaaaaaaaaaaaaaaaaaaaaaaaaaaaaaaaaaaaaaaaaaaaaaaaaaaaaa
aaaaaaaaaaaaaaaaaaaaaaaaaaaaaaaaaaaaaaaaaaaaaaaaaaaaaaaaaaaa
aaaaaaaaaaaaaaaaaaaaaaaaaaaaaaaaaaaaaaaaaaaaaaaaaaaaaaaaaaaa
aaaaaaaaaaaaaaaaaaaaaaaaaaaaaaaaaaaaaaaaaaaaaaaaaaaaaaaaaaaa
aaaaaaaaaaaaaaaaaaaaaaaaaaaaaaaaaaaaaaaaaaaaaaaaaaaaaaaaaaaa
aaaaaaaaaaaaaaaaaaaaaaaaaaaaaaaaaaaaaaaaaaaaaaaaaaaaaaaaaaaa
aaaaaaaaaaaaaaaaaaaaaaaaaaaaaaaaaaaaaaaaaaaaaaaaaaaaaaaaaaaa
aaaaaaaaaaaaaaaaaaaaaaaaaaaaaaaaaaaaaaaaaaaaaaaaaaaaaaaaaaaa
aaaaaaaaaaaaaaaaaaaaaaaaaaaaaaaaaaaaaaaaaaaaaaaaaaaaaaaaaaaa
aaaaaaaaaaaaaaaaaaaaaaaaaaaaaaaaaaaaaaaaaaaaaaaaaaaaaaaaaaaa
aaaaaaaaaaaaaaabacacacacacacacacacacacacacadaaaaaaaaaaaaaaaa
aaaaaaaaaaaaaaaeafafafafafafafafafafafafafagaaaaaaaaaaaaaaaa
aaaaaaaaaaaaaaaeafafafafafafafafafafafafafagaaahahahahaaahaa
aaaaaaaiajakaaaeafafafafafafafafafafafafafagaaalalalalahalah
aaaaaaamanaoaaaeafafafafafafafafafafafafafagaaapapapapapapap
aaaaaaaqarasaaaeafafafafafafafafafafafafafagaaaaaaaaataaaaaa
aaaaaaaaauaaaaaeafafafafafafafafafafafafafagaaaaaaaaaaaaaaaa
aaaaaaaaaaaaaaaeafafafafafafafafafafafafafagaaaaaaaaaaaaaaaa
aaaaaaaaaaaaaaaeafafafafafafafafafafafafafagaaaaaaaaaaaaaaaa
aaaaavajakaaaaaeafafafafafafafafafafafafafagaaaaaiawakaaaaaa
aaaaamanaoaaaaaeafafafafafafafafaxayayayayazaaaaaAaBaCaaaaaa
aaaaaDaraEaaaaaFayayayayayayayayazaaaaaiawakaaaaaqaGasaaaaaa
aaaaaaaHaaaaaIaaaaaaataaaaaJaKaaaLaaaaaAaBaCaaaaaaaHaaaaaaaa
aaaaaaaaaaaaaaaaaaaLaaaMaaaaaaaNaaaaaaaqaGasaaaaaaaaaaaaaaaa
aaaaaIaaaaaaaaataaaaaaaaaaaOaaaaaIaaataaauaaaPaQaQaRaaaaaaaa
aaaaaaaaaaaLaaaaaaaaaNaaaaaaaaaMaaaaaJaaaaaaaSaTaUaVaaaaaaaa
aaaWaWaWaWaWaIaaaaaaaaaaaJaaaIaaaaaLaaaXaXaaaSaYaZaVaaaaaaaa
aaaWaWaWaWaWaaaaaLaaaaaMaaataaaNaaaaaaaXaXaababbbbbcaaaaaaaa
aabdbdbdbdbdaaaaaaaaaaaaaaaaaaaaaaaaaaaaaaaaaaaaaaaaaaaaaaaa
"}
