"a" = (/turf/Filler,/area)
"b" = (/turf/Cave/CaveWallN,/area)
"c" = (/turf/Cave/CaveWallC,/area)
"d" = (/turf/Cave/CaveWallS,/area)
"e" = (/turf/Cave/CaveRimNW,/area)
"f" = (/turf/Cave/CaveRimN,/area)
"g" = (/turf/Cave/CaveRimNE,/area)
"h" = (/turf/Cave/CavefloorC,/area)
"i" = (/turf/Cave/CaveRimS,/area)
"j" = (/turf/Cave/CaveRimW,/area)
"k" = (/turf/Cave/CaveRimE,/area)
"l" = (/turf/Start,/area)
"m" = (/turf/Cave/CaveWallE,/area)
"n" = (/obj/Pushable_Boulder,/turf/Cave/CavefloorC,/area)
"o" = (/turf/Cave/CaveWallSE,/area)
"p" = (/turf/Cave/CaveWallNW,/area)
"q" = (/turf/Cave/CaveWallNE,/area)
"r" = (/turf/Cave/CaveRimSW,/area)
"s" = (/turf/Cave/CaveRimSW2,/area)
"t" = (/turf/Cave/CaveRimSE2,/area)
"u" = (/turf/Cave/CaveRimSE,/area)
"v" = (/turf/Cave/CavefloorE2,/area)
"w" = (/turf/Cave/CaveWallW,/area)
"x" = (/turf/Cave/CaveWallTop,/area)
"y" = (/turf/Cave/CaveWallSW,/area)
"z" = (/turf/Cave/CaveWallMid,/area)
"A" = (/turf/Bush3,/area)
"B" = (/obj/Bigrock,/turf/Cave/CavefloorC,/area)
"C" = (/turf/Cave/CaveWallBot,/area)
"D" = (/mob/Enemies/skele_archer,/turf/Cave/CavefloorC,/area)
"E" = (/turf/Cave/CaveRimNW2,/area)
"F" = (/turf/Cave/CaveRimNE2,/area)
"G" = (/mob/Enemies/zombie_guy,/turf/Cave/CavefloorC,/area)
"H" = (/obj/Pushable_Boulder,/turf/Cave/CaveRimS,/area)

(1,1,1) = {"
aaaaaaaaaaaaaaaaaaaaaaaaabbbbbbbbbbbbbbbbbbbbbbbbbbbbbb
aaaaaaaaaaaaaaaaaaaaaaacccccccccccccccccccccccccccccccc
accccccccccaaaaaaaaaaaadddddddddddddddddddddddddddddddd
aceffffffgcaahhhhhhaiiiiihhhhhhhhhhhhhhhhhhhhhhhhhhhhhh
acjhhhhhhkcaahhhhhhaccccchhhhhhhhhhhhhhhhhhhhhhhhhhhhhh
acjhlhhhhkcaahhhhhhaccccmhhhhhhhhhhhhhhhhhhhhhhhhhhhhhh
acjhhhnhhkcaahhhhhhaddddopqhhhhhhhhhhhhhhhhhhhhhhhhhhhh
acrishhtiucaavaaaaaahhhhhwmhhhhhhhhhhhhhhhhhhhhhhhhhhhh
acccjhhkcccaaaaaawcmhnxhhyohhhhhhhhhhhhhhhhhhhhhhhhhhhh
aaacjhhkcacaaaaaaydonhzhnhAhhhhhhhhhhhhhhhhhhhhhhhhhhhh
acccjhhkcccaaaawmBhhnhCnDnAAAAAAhhhhhhhhhhhhhhhhhhhhhhh
acefEfhFfgcwccmyohhhhDBhnGhhhhhhhhhhhhhhhhhhhhhhhhhhhhh
acjhhhhhhFfyddohhhnBBBBhhhhhhhhhhhhhhhhhhhhhhhhhhhhhhhh
ceEhhhhhhhhhhhhhhxhnhhhnhhAAAhhhhhhhhhhhhhhhhhhhhhhhhhh
crishhhhhhhhhhhhhzhhhGhhtAAcAAAhhhhhhhhhhhhhhhhhhhhhhhh
cccrishhhhhhhhhhhCnhhhtiuccaccAAAhhhhhhhhhhhhhhhhhhhhhh
aaaccrishhhhhhhhtiHiiiucccaaacccAhhhhhhhhhhhhhhhhhhhhhh
aaaccccriiiiiiiiucccccccaaaaaaaachhhhhhhhhhhhhhhhhhhhhh
"}
