"a" = (/turf/Cave/CaveWallN,/area)
"b" = (/turf/Cave/CaveWallC,/area)
"c" = (/turf/Cave/CaveWallS,/area)
"d" = (/turf/Cave/CavefloorC,/area)
"e" = (/turf/Cave/CaveRimNW,/area)
"f" = (/turf/Cave/CaveRimN,/area)
"g" = (/turf/Cave/CaveRimNE,/area)
"h" = (/turf/Cave/CaveRimW,/area)
"i" = (/turf/Cave/CaveRimE,/area)
"j" = (/turf/Cave/CaveWallNW,/area)
"k" = (/turf/Cave/CaveWallNE,/area)
"l" = (/turf/Start,/area)
"m" = (/turf/Cave/CaveWallW,/area)
"n" = (/turf/Cave/CaveWallE,/area)
"o" = (/mob/objects/Boulder,/turf/Cave/CavefloorC,/area)
"p" = (/turf/Cave/CaveWallSW,/area)
"q" = (/turf/Cave/CaveWallSE,/area)
"r" = (/turf/Cave/CaveRimSW,/area)
"s" = (/turf/Cave/CaveRimS,/area)
"t" = (/turf/Cave/CaveRimSW2,/area)
"u" = (/turf/Cave/CaveRimSE2,/area)
"v" = (/turf/Cave/CaveRimSE,/area)
"w" = (/turf/Cave/CavefloorE2,/area)
"x" = (/turf/Cave/CaveWallTop,/area)
"y" = (/turf/Cave/CaveWallMid,/area)
"z" = (/turf/Bush3,/area)
"A" = (/obj/Bigrock,/turf/Cave/CavefloorC,/area)
"B" = (/turf/Cave/CaveWallBot,/area)
"C" = (/turf/Cave/CaveRimNW2,/area)
"D" = (/turf/Cave/CaveRimNE2,/area)
"E" = (/mob/Enemies/zombie_guy,/turf/Cave/CavefloorC,/area)
"F" = (/turf,/area)

(1,1,1) = {"
aaaaaaaaaaaaaaaaaaaaaaaaaaaaaaaaaaaaaaaaaaaaaaaaaaaaaaa
bbbbbbbbbbbbbbbbbbbbbbbbbbbbbbbbbbbbbbbbbbbbbbbbbbbbbbb
cbbbbbbbbbbcccccccccccccccccccccccccccccccccccccccccccc
dbeffffffgbdddddddddddddddddddddddddddddddddddddddddddd
dbhddddddibddddddddjaaaakdddddddddddddddddddddddddddddd
dbhdlddddibddddddddmbbbbndddddddddddddddddddddddddddddd
dbhdddoddibddddddddpccccqjkdddddddddddddddddddddddddddd
dbrstddusvbwwwwwwjakdddddmndddddddddddddddddddddddddddd
dbbbhddibbbwwwwddmbndoxddpqdddddddddddddddddddddddddddd
dddbhddibbbwwwwjkpcqodydodzdddddddddddddddddddddddddddd
dbbbhddibbbjaakmnAddodBodozzzzzzddddddddddddddddddddddd
dbefCfdDfgbmbbnpqdddddAdoEddddddddddddddddddddddddddddd
dbhddddddDfpccqdddoAAAAdddddddddddddddddddddddddddddddd
dfCddddddddddddddxdodddoddzzzdddddddddddddddddddddddddd
dzzzdddddddddddddydddEddzzzdzzzdddddddddddddddddddddddd
FFdzzzdddddddddddBodddzzzdddddzzzdddddddddddddddddddddd
FFdddzzzddddddddzzzzzzddddddddddzdddddddddddddddddddddd
FFdddddzzzzzzzzzzdddddddddddddddddddddddddddddddddddddd
"}
