"a" = (/turf/Cave/CaveWallC,/area)
"b" = (/turf/Cave2/NewCaveWallRimW,/area)
"c" = (/turf/Cave2/NewCaveWallRimE,/area)
"d" = (/turf/Cave2/NewCaveWallC,/area)
"e" = (/turf/Cave2/NewCaveWallNW,/area)
"f" = (/turf/Cave2/NewCaveWallN,/area)
"g" = (/turf/Cave2/NewCaveWallNE,/area)
"h" = (/turf/Cave/CavefloorC,/area)
"i" = (/turf/Cave/CaveWallN,/area)
"j" = (/turf/Cave2/NewCaveWallS,/area)
"k" = (/turf/Cave2/NewCaveWallW,/area)
"l" = (/turf/Cave2/NewCaveWallE,/area)
"m" = (/turf/Cave2/NewCaveWallSW,/area)
"n" = (/turf/Cave2/NewCaveWallSE,/area)
"o" = (/turf/Cave/CaveWallS,/area)
"p" = (/turf/Start,/area)
"q" = (/obj/Pushable_Boulder,/turf/Cave/CavefloorC,/area)
"r" = (/turf/Cave/CaveRimSW2,/area)
"s" = (/turf/Cave/CaveWallW,/area)
"t" = (/turf/Cave/CaveWallTop,/area)
"u" = (/turf/Cave/CaveWallE,/area)
"v" = (/turf/Cave/CaveWallMid,/area)
"w" = (/obj/Bigrock,/turf/Cave/CavefloorC,/area)
"x" = (/turf/Cave/CaveWallBot,/area)
"y" = (/mob/Enemies/skele_archer,/turf/Cave/CavefloorC,/area)
"z" = (/mob/Enemies/zombie_guy,/turf/Cave/CavefloorC,/area)
"A" = (/turf/Cave/CaveRimSE2,/area)
"B" = (/turf/Cave/CaveRimS,/area)
"C" = (/turf/Filler,/area)

(1,1,1) = {"
aaaaaaaaabcbdddddddddddefgbhhhhhhhhhhhhffgiiiiiiiiiiiii
aaaaaaaaabcbjjjjjjjjjjjkalbhhhhhhhhhhhhaalaaaaaaaaaaaaa
jjjjjjjjjbcbhhhhhhhhhhhmjnbhhhhhhhhhhhhjjnooooooooooooo
hhhhhhhhhbcbhhhhhhhhhhhhhhbhhhhhhhhhhhhhhhhhhhhhhhhhhhh
hhhhhhhhhbcbhhhhhhhcefffgbbhhhhhhhhhhhhhhhhhhhhhhhhhhhh
hhhhphhhhbcbhhhhhhhckaaalbbhhhhhhhhhhhhhhhhhhhhhhhhhhhh
hhhhhhqbhbcbhhhhhhhcmjjjneefrhhhhhhhhhhhhhhhhhhhhhhhhhh
hhhchhhefegbhhhhcefghhhhhssdefrhhhhhhhhhhhhhhhhhhhhhhhh
fffghhhsaslbhhhhckalhqthhmsdsdeffhhhhhhhhhhhhhhhhhhhhhh
aaulhhhsaslbhhcegmjnqhvhqhsdsdsddhhhhhhhhhhhhhhhhhhhhhh
aaunhhhmjkleffgklwhhqhxqyqmjsdsddhhhhhhhhhhhhhhhhhhhhhh
aanhhhhhhmnkaalmnhhhhywhqzhhmjsddhhhhhhhhhhhhhhhhhhhhhh
abhhhhhhhhhmjjnhhhqwwwwhhhhhhhmjjhhhhhhhhhhhhhhhhhhhhhh
abhhhhhhhhhhhhhhhthqhhhqhhAfrhhhhhhhhhhhhhhhhhhhhhhhhhh
aeBrhhhhhhhhhhhhhvhhhzhhAfgaefrhhhhhhhhhhhhhhhhhhhhhhhh
akaeBrhhhhhhhhhhhxqhhhAfgalakaefrhhhhhhhhhhhhhhhhhhhhhh
CsasaeBrhhhhhhhhhAefffgalauasakaehhhhhhhhhhhhhhhhhhhhhh
CkakakaefffffffffgkaaalaualCkasakhhhhhhhhhhhhhhhhhhhhhh
"}
