"a" = (/turf/Cave/CaveWallN,/area)
"b" = (/turf/Cave/CaveWallC,/area)
"c" = (/turf/Cave/CaveWallS,/area)
"d" = (/turf/Cave/CaveRimNW,/area)
"e" = (/turf/Cave/CaveRimN,/area)
"f" = (/turf/Cave/CaveRimNE,/area)
"g" = (/turf/Cave/CavefloorC,/area)
"h" = (/turf/Cave/CaveRimSE2,/area)
"i" = (/turf/Cave/CaveRimS,/area)
"j" = (/turf/Cave/CaveRimW,/area)
"k" = (/turf/Cave/CaveRimE,/area)
"l" = (/turf/Start,/area)
"m" = (/turf/Cave/CaveWallE,/area)
"n" = (/obj/Pushable_Boulder,/turf/Cave/CavefloorC,/area)
"o" = (/turf/Cave/CaveWallSE,/area)
"p" = (/turf/Cave/CaveWallNW,/area)
"q" = (/turf/Cave/CaveWallNE,/area)
"r" = (/turf/Cave/CaveRimSW,/area)
"s" = (/turf/Cave/CaveRimSW2,/area)
"t" = (/turf/Cave/CaveRimSE,/area)
"u" = (/turf/Cave/CavefloorE2,/area)
"v" = (/turf/Cave/CaveWallW,/area)
"w" = (/turf/Cave/CaveWallTop,/area)
"x" = (/turf/Cave/CaveWallSW,/area)
"y" = (/turf/Cave/CaveWallMid,/area)
"z" = (/turf/Bush3,/area)
"A" = (/obj/Bigrock,/turf/Cave/CavefloorC,/area)
"B" = (/turf/Cave/CaveWallBot,/area)
"C" = (/mob/Enemies/skele_archer,/turf/Cave/CavefloorC,/area)
"D" = (/turf/Cave/CaveRimNW2,/area)
"E" = (/turf/Cave/CaveRimNE2,/area)
"F" = (/mob/Enemies/zombie_guy,/turf/Cave/CavefloorC,/area)
"G" = (/obj/Pushable_Boulder,/turf/Cave/CaveRimS,/area)

(1,1,1) = {"
aaaaaaaaaaaaaaaaaaaaaaaaaaaaaaaaaaaaaaaaaaaaaaaaaaaaaaa
bbbbbbbbbbbbbbbbbbbbbbbbbbbbbbbbbbbbbbbbbbbbbbbbbbbbbbb
bbbbbbbbbbbcccccccccccccccccccccccccccccccccccccccccccc
bbdeeeeeefbgggggggghiiiiigggggggggggggggggggggggggggggg
bbjggggggkbggggggggkbbbbbgggggggggggggggggggggggggggggg
bbjglggggkbggggggggkbbbbmgggggggggggggggggggggggggggggg
bbjgggnggkbgggggggghccccopqgggggggggggggggggggggggggggg
bbrisgghitbuuuuuupaqgggggvmgggggggggggggggggggggggggggg
bbbbjggkbbbuuuuggvbmgnwggxogggggggggggggggggggggggggggg
bbbbjggkbbbuuuupqxcongygngzgggggggggggggggggggggggggggg
bbbbjggkbbbpaatvmAggngBnCnzzzzzzggggggggggggggggggggggg
bbdeDegEefbvbbmxoggggCAgnFggggggggggggggggggggggggggggg
bbjggggggEexccogggnAAAAgggggggggggggggggggggggggggggggg
bdDggggggggggggggwgngggnggzzzgggggggggggggggggggggggggg
brisgggggggggggggygggFgghzzbzzzgggggggggggggggggggggggg
bbbrisgggggggggggBnggghitbbbbbzzzgggggggggggggggggggggg
bbbbbrisgggggggghiGiiitbbbbbbbbbzgggggggggggggggggggggg
bbbbbbbriiiiiiiitbbbbbbbbbbbbbbbbgggggggggggggggggggggg
"}
