"a" = (/turf/Cave/CaveWallN,/area)
"b" = (/turf/Cave/CaveWallC,/area)
"c" = (/turf/Cave/CaveWallS,/area)
"d" = (/turf/Cave/CavefloorC,/area)
"e" = (/turf/DirtgrassNW,/area)
"f" = (/turf/DirtgrassN,/area)
"g" = (/turf/DirtgrassNE,/area)
"h" = (/turf/Cave/CaveWallNW,/area)
"i" = (/turf/Cave/CaveWallNE,/area)
"j" = (/turf/DirtgrassE,/area)
"k" = (/turf/Start,/area)
"l" = (/turf/Cave/CaveWallW,/area)
"m" = (/turf/Cave/CaveWallE,/area)
"n" = (/mob/objects/Boulder,/turf/Cave/CavefloorC,/area)
"o" = (/turf/DirtgrassS,/area)
"p" = (/turf/Cave/CaveWallSW,/area)
"q" = (/turf/Cave/CaveWallSE,/area)
"r" = (/turf/Bush3,/area)
"s" = (/turf/Cave/CavefloorE2,/area)
"t" = (/turf/Cave/CaveWallTop,/area)
"u" = (/turf/Cave/CaveWallMid,/area)
"v" = (/obj/Bigrock,/turf/Cave/CavefloorC,/area)
"w" = (/turf/Cave/CaveWallBot,/area)
"x" = (/mob/Enemies/zombie_guy,/turf/Cave/CavefloorC,/area)
"y" = (/turf,/area)

(1,1,1) = {"
aaaaaaaaaaaaaaaaaaaaaaaaaaaaaaaaaaaaaaaaaaaaaaaaaaaaaaa
bbbbbbbbbbbbbbbbbbbbbbbbbbbbbbbbbbbbbbbbbbbbbbbbbbbbbbb
ccccccccccccccccccccccccccccccccccccccccccccccccccccccc
ddddddddddddddddddddddddddddddddddddddddddddddddddddddd
dddeffffgddddddddddhaaaaidddddddddddddddddddddddddddddd
dddjkdddeddddddddddlbbbbmdddddddddddddddddddddddddddddd
dddjddndoddddddddddpccccqhidddddddddddddddddddddddddddd
dddrddddrsssssssshaidddddlmdddddddddddddddddddddddddddd
dddhiddhissssssddlbmdntddpqdddddddddddddddddddddddddddd
dddlmddlmhisssshipcqndudndrdddddddddddddddddddddddddddd
dddpqddpqlmhaailmvddndwndnrrrrrrddddddddddddddddddddddd
ddrrdddddpqlbbmpqdddddvdnxddddddddddddddddddddddddddddd
ddrddddddddpccqdddnvvvvdddddddddddddddddddddddddddddddd
drrddddddddddddddtdndddnddrrrdddddddddddddddddddddddddd
drrrdddddddddddddudddxddrrrdrrrdddddddddddddddddddddddd
yydrrrdddddddddddwndddrrrdddddrrrdddddddddddddddddddddd
yydddrrrddddddddrrrrrrddddddddddrdddddddddddddddddddddd
yydddddrrrrrrrrrrdddddddddddddddddddddddddddddddddddddd
"}
