"a" = (/turf/Cave/CaveWallN,/area)
"b" = (/turf/Cave/CaveWallC,/area)
"c" = (/turf/Cave/CaveWallS,/area)
"d" = (/turf/Cave/CavefloorC,/area)
"e" = (/turf/Cave/CaveRimNW,/area)
"f" = (/turf/Cave/CaveRimN,/area)
"g" = (/turf/Cave/CaveRimNE,/area)
"h" = (/turf/Cave/CaveRimSE2,/area)
"i" = (/turf/Cave/CaveRimS,/area)
"j" = (/turf/Cave/CaveRimW,/area)
"k" = (/turf/Cave/CaveRimE,/area)
"l" = (/turf/Start,/area)
"m" = (/turf/Cave/CaveWallE,/area)
"n" = (/obj/Pushable_Boulder,/turf/Cave/CavefloorC,/area)
"o" = (/turf/Cave/CaveWallSE,/area)
"p" = (/turf/Cave/CaveWallNW,/area)
"q" = (/turf/Cave/CaveWallNE,/area)
"r" = (/turf/Cave/CaveRimSW,/area)
"s" = (/turf/Cave/CaveRimSW2,/area)
"t" = (/turf/Cave/CaveRimSE,/area)
"u" = (/turf/Cave/CavefloorE2,/area)
"v" = (/turf/Cave/CaveWallW,/area)
"w" = (/turf/Cave/CaveWallTop,/area)
"x" = (/turf/Cave/CaveWallSW,/area)
"y" = (/turf/Cave/CaveWallMid,/area)
"z" = (/turf/Bush3,/area)
"A" = (/obj/Bigrock,/turf/Cave/CavefloorC,/area)
"B" = (/turf/Cave/CaveWallBot,/area)
"C" = (/turf/Cave/CaveRimNW2,/area)
"D" = (/turf/Cave/CaveRimNE2,/area)
"E" = (/mob/Enemies/zombie_guy,/turf/Cave/CavefloorC,/area)
"F" = (/turf,/area)

(1,1,1) = {"
aaaaaaaaaaaaaaaaaaaaaaaaaaaaaaaaaaaaaaaaaaaaaaaaaaaaaaa
bbbbbbbbbbbbbbbbbbbbbbbbbbbbbbbbbbbbbbbbbbbbbbbbbbbbbbb
cbbbbbbbbbbcccccccccccccccccccccccccccccccccccccccccccc
dbeffffffgbddddddddhiiiiidddddddddddddddddddddddddddddd
dbjddddddkbddddddddkbbbbbdddddddddddddddddddddddddddddd
dbjdlddddkbddddddddkbbbbmdddddddddddddddddddddddddddddd
dbjdddnddkbddddddddhccccopqdddddddddddddddddddddddddddd
dbrisddhitbuuuuuupaqdddddvmdddddddddddddddddddddddddddd
dbbbjddkbbbuuuuddvbmdnwddxodddddddddddddddddddddddddddd
dddbjddkbbbuuuupqxcondydndzdddddddddddddddddddddddddddd
dbbbjddkbbbpaatvmAddndBndnzzzzzzddddddddddddddddddddddd
dbefCfdDfgbvbbmxodddddAdnEddddddddddddddddddddddddddddd
dbjddddddDfxccodddnAAAAdddddddddddddddddddddddddddddddd
deCddddddddddddddwdndddnddzzzdddddddddddddddddddddddddd
drisdddddddddddddydddEddhzzdzzzdddddddddddddddddddddddd
FFdrisdddddddddddBndddhitdddddzzzdddddddddddddddddddddd
FFdddrisddddddddhiiiiitdddddddddzdddddddddddddddddddddd
FFdddddriiiiiiiitdddddddddddddddddddddddddddddddddddddd
"}
