"a" = (/turf/Cave/CavefloorC,/area/outside)
"b" = (/obj/food/Berry,/turf/Cave/CavefloorC,/area/outside)
"c" = (/obj/Pushable_Boulder,/turf/Cave/CavefloorC,/area/outside)
"d" = (/obj/food/Acorns,/turf/Cave/CavefloorC,/area/outside)
"e" = (/turf/Cave/CavefloorC,/turf/Cave/CaveWallRimNW,/area/outside)
"f" = (/turf/Cave/CavefloorC,/turf/Cave/CaveWallRimN,/area/outside)
"g" = (/turf/Cave/CavefloorC,/turf/Cave/CaveWallRimNE,/area/outside)
"h" = (/turf/Cave/CaveWallRimW,/area/outside)
"i" = (/turf/Cave/CaveWallRimE,/area/outside)
"j" = (/turf/Cave/CaveWallNW,/area/outside)
"k" = (/turf/Cave/CaveWallN,/area/outside)
"l" = (/turf/Cave/CaveWallNE,/area/outside)
"m" = (/turf/Cave/CaveWallW,/area/outside)
"n" = (/turf/Cave/CaveWallC,/area/outside)
"o" = (/turf/Cave/CaveWallE,/area/outside)
"p" = (/turf/Cave/CaveWallSW,/area/outside)
"q" = (/turf/Cave/CaveWallS,/area/outside)
"r" = (/turf/Cave/CaveWallSE,/area/outside)

(1,1,1) = {"
aaaaaaaaaaaaaaaaaaaaaaaaaaaaaaaaaaa
aaaaaaaaaaaaaaaaaaaaaaaaaaaaaaaaaaa
aaaaaaaaaaaaaaaaaaaaaaaaaaaaaaaaaaa
aaaaaaaaaaaaaaaaaaaaaaaaaaaaaaaaaaa
aaaaaaaaaaaaaaaaaaaaaaaaaaaaaaaaaaa
aaaaaaaaaaaaaaaaaaaaaaaaaaaaaaaaaaa
aaaaaaaaaaaaaaaaaaaaaaaaaaaaaaaaaaa
aaaaaaaaaaaaaaaaaaaaaaaaaaaaaaaaaaa
aaaaabaaaaaaaaaaaaaaaaaaaaaaaaaaaaa
acaaaaaadaaaaaaaaaaaaaaaaaaaaaaaaaa
aaaaaaaaaaaaaaaaaaaaaaaaaaaaaaaaaaa
aaaaaaaaaaacaaaaaaaaaaaaaaaaaaaaaaa
aaefgaaabaaaaaaaaaaaaaaaaaaaaaaaaaa
aahaiaaaaaaaaaaaaaaaaaaaaaaaaaaaaaa
aajklaaaadaaaaaaaaaaaaaaaaaaaaaaaaa
aamnoaaaaaaaaaaaaaaaaaaaaaaaaaaaaaa
aapqraaacaaaaaaaaaaaaaaaaaaaaaaaaaa
aaaaaaaaaaaaaaaaaaaaaaaaaaaaaaaaaaa
"}
