"a" = (/turf/Cave/CaveWallC,/area)
"b" = (/turf/Cave2/NewCaveWallRimW,/area)
"c" = (/turf/Cave2/NewCaveWallRimE,/area)
"d" = (/turf/Cave2/NewCaveWallC,/area)
"e" = (/turf/Cave2/NewCaveWallNW,/area)
"f" = (/turf/Cave2/NewCaveWallN,/area)
"g" = (/turf/Cave2/NewCaveWallNE,/area)
"h" = (/turf/Cave/CavefloorC,/area)
"i" = (/turf/Cave/CaveWallN,/area)
"j" = (/turf/Cave2/NewCaveWallS,/area)
"k" = (/turf/Cave2/NewCaveWallW,/area)
"l" = (/turf/Cave2/NewCaveWallE,/area)
"m" = (/turf/Cave2/NewCaveWallSW,/area)
"n" = (/turf/Cave2/NewCaveWallSE,/area)
"o" = (/turf/Cave/CaveWallS,/area)
"p" = (/turf/Start,/area)
"q" = (/turf/Cave/CaveRimSW2,/area)
"r" = (/turf/Cave2/Stairs1,/area)
"s" = (/turf/Cave2/Stairs5,/area)
"t" = (/turf/Cave2/Stairs4,/area)
"u" = (/turf/Cave/CaveWallW,/area)
"v" = (/turf/Cave2/Stairs2,/area)
"w" = (/obj/Pushable_Boulder,/turf/Cave/CavefloorC,/area)
"x" = (/turf/Cave/CaveWallTop,/area)
"y" = (/turf/Cave/CaveWallE,/area)
"z" = (/turf/Cave2/Stairs3,/area)
"A" = (/turf/Cave/CaveWallMid,/area)
"B" = (/obj/Bigrock,/turf/Cave/CavefloorC,/area)
"C" = (/turf/Cave/CaveWallBot,/area)
"D" = (/mob/Enemies/skele_archer,/turf/Cave/CavefloorC,/area)
"E" = (/mob/Enemies/zombie_guy,/turf/Cave/CavefloorC,/area)
"F" = (/turf/Cave/CaveRimSE2,/area)
"G" = (/turf/Cave/CaveRimS,/area)
"H" = (/turf/Filler,/area)

(1,1,1) = {"
aaaaaaaaabcbdddddddddddefgbhhhhhhhhhhhhffgiiiiiiiiiiiii
aaaaaaaaabcbjjjjjjjjjjjkalbhhhhhhhhhhhhaalaaaaaaaaaaaaa
jjjjjjjjjbcbhhhhhhhhhhhmjnbhhhhhhhhhhhhjjnooooooooooooo
hhhhhhhhhbcbhhhhhhhhhhhhhhbhhhhhhhhhhhhhhhhhhhhhhhhhhhh
hhhhhhhhhbcbhhhhhhhcefffgbbhhhhhhhhhhhhhhhhhhhhhhhhhhhh
hhhhphhhhbcbhhhhhhhckaaalbbhhhhhhhhhhhhhhhhhhhhhhhhhhhh
hhhhhhhbhbcbhhhhhhhcmjjjneefqhhhhhhhhhhhhhhhhhhhhhhhhhh
hhhcrstefegbhhhhcefghhhhhuudefqhhhhhhhhhhhhhhhhhhhhhhhh
fffgvssuaulbhhhhckalhwxhhmududeffhhhhhhhhhhhhhhhhhhhhhh
aaylszruaulbhhcegmjnwhAhwhudududdhhhhhhhhhhhhhhhhhhhhhh
aaynsrsmjkleffgklBhhwhCwDwmjududdhhhhhhhhhhhhhhhhhhhhhh
aanhhhhhhmnkaalmnhhhhDBhwEhhmjuddhhhhhhhhhhhhhhhhhhhhhh
abhhhhhhhhhmjjnhhhwBBBBhhhhhhhmjjhhhhhhhhhhhhhhhhhhhhhh
abhhhhhhhhhhhhhhhxhwhhhwhhFfqhhhhhhhhhhhhhhhhhhhhhhhhhh
aeGqhhhhhhhhhhhhhAhhhEhhFfgaefqhhhhhhhhhhhhhhhhhhhhhhhh
akaeGqhhhhhhhhhhhCwhhhFfgalakaefqhhhhhhhhhhhhhhhhhhhhhh
HuauaeGqhhhhhhhhhFefffgalayauakaehhhhhhhhhhhhhhhhhhhhhh
HkakakaefffffffffgkaaalayalHkauakhhhhhhhhhhhhhhhhhhhhhh
"}
