"a" = (/turf/Cave/CavefloorC,/area/outside)
"b" = (/obj/Bigrock,/turf/Cave/CavefloorC,/area/outside)
"c" = (/mob/Enemies/zombie_guy,/turf/Cave/CavefloorC,/area/outside)
"d" = (/obj/food/Berry,/turf/Cave/CavefloorC,/area/outside)
"e" = (/obj/Pushable_Boulder,/turf/Cave/CavefloorC,/area/outside)
"f" = (/obj/trap/SlideTrap,/turf/Cave/CavefloorC,/area/outside)
"g" = (/turf/Cave/CavefloorC,/turf/Cave/CaveWallRimNW,/area/outside)
"h" = (/turf/Cave/CavefloorC,/turf/Cave/CaveWallRimN,/area/outside)
"i" = (/turf/Cave/CavefloorC,/turf/Cave/CaveWallRimNE,/turf/Cave/CaveWallRimN,/area/outside)
"j" = (/turf/Cave/CavefloorC,/turf/Cave/CaveWallRimNW,/turf/Cave/CaveWallRimN,/area/outside)
"k" = (/turf/Cave/CavefloorC,/turf/Cave/CaveWallRimNE,/area/outside)
"l" = (/turf/Cave/CaveWallRimW,/area/outside)
"m" = (/mob/Enemies/skele_archer,/turf/Cave/CavefloorC,/area/outside)
"n" = (/turf/Cave/CaveWallRimE,/area/outside)
"o" = (/turf/Cave/CaveWallNW,/area/outside)
"p" = (/turf/Cave/CaveWallN,/area/outside)
"q" = (/turf/Cave/CaveWallNE,/area/outside)
"r" = (/turf/Cave/Stairs1,/area/outside)
"s" = (/turf/Cave/Stairs2,/area/outside)
"t" = (/turf/Cave/Stairs3,/area/outside)
"u" = (/obj/food/Acorns,/turf/Cave/CavefloorC,/area/outside)
"v" = (/turf/Cave/CaveWallW,/area/outside)
"w" = (/turf/Cave/CaveWallC,/area/outside)
"x" = (/turf/Cave/CaveWallE,/area/outside)
"y" = (/turf/Cave/Stairs4,/area/outside)
"z" = (/turf/Cave/Stairs5,/area/outside)
"A" = (/turf/Cave/CaveWallSW,/area/outside)
"B" = (/turf/Cave/CaveWallS,/area/outside)
"C" = (/turf/Cave/CaveWallSE,/area/outside)

(1,1,1) = {"
aaaaaaaaaaaaaaaaaaaaaaaaaaaaaaaaaaa
aaaaaaaaaaaaaaaaaaaaaaaaaaaaaaaaaaa
aaaaaaaaaaaaaaaaaaaaaaaaaaaaaaaaaaa
aaaaaaaaaaaaaaaaaaaaaaaaaaaaaaaaaaa
aaaaaaaaaaaaaaaaaaaaaaaaaaaaaaaaaaa
aaaaaaaaaaaaaaaaaaaaabaaaaaaaaaaaaa
acaaaaaaaaaaaaaaaaaaaaaaaaaaaaaaaaa
aaaaaaaaacaaaaaaaaaaaaaaaaaaaaaaaaa
aaaaadaaaaaaaaaaaaaaaaaaaaaaaaaaaaa
aeaaaaaaaaaaaaaaaaaaaaaaaaaaaaaaaaa
aaaaaaaaaaaaacabaaaaafaaaaabaaaaaaa
aaghihhhjhkeaaaaaaaaaaaaaaaaaaaaaaa
aalmaaaaadnaaaaaaaaaaaaaaaaaaaaaaaa
aaopqrstopqaaaauaaaaaaaaaaaaaaaaaaa
aavwxryzvwxaadauaaaaaaaaaaaaaaaaaaa
aaABCtryABCaadaauaaaabaaaaaaaaaaaaa
aaaaaaaaeaaaaaaaaamaaaaaaaaaaaaaaaa
aaaaaaaaaaaaaaaaaaaaaaaaaaaaaaaaaaa
"}
