"a" = (/turf/grass,/area)
"b" = (/turf/DirtgrassNW,/area)
"c" = (/turf/DirtgrassN,/area)
"d" = (/turf/DirtgrassNE,/area)
"e" = (/turf/DirtgrassS,/area)
"f" = (/turf/Dirt,/area)
"g" = (/turf/DirtWaterSE2,/area)
"h" = (/turf/DirtWaterW,/area)
"i" = (/turf/DirtWaterSW2,/area)
"j" = (/turf/DirtgrassE,/area)
"k" = (/turf/DirtWaterE,/area)
"l" = (/turf/Water,/area)
"m" = (/turf/DirtWaterS,/area)
"n" = (/turf/DirtWaterSE,/area)
"o" = (/turf/DirtWaterNE2,/area)
"p" = (/turf/DirtWaterN,/area)
"q" = (/turf/DirtWaterNW2,/area)
"r" = (/turf/DirtgrassSW,/area)
"s" = (/turf/DirtgrassW,/area)
"t" = (/turf/DirtgrassSE,/area)
"u" = (/obj/TreetopNW,/turf/grass,/area)
"v" = (/obj/TreetopN,/turf/grass,/area)
"w" = (/obj/TreetopNE,/turf/grass,/area)
"x" = (/obj/TreetopW,/turf/grass,/area)
"y" = (/obj/Treecenter1,/turf/grass,/area)
"z" = (/obj/TreetopE,/turf/grass,/area)
"A" = (/turf/Start,/area)
"B" = (/obj/TreetopSW,/turf/grass,/area)
"C" = (/obj/TreetopS,/turf/grass,/area)
"D" = (/obj/TreetopSE,/turf/grass,/area)
"E" = (/obj/Treestump1,/turf/grass,/area)

(1,1,1) = {"
aaaaaaaaaaaaaaaaaaaa
aaaaaaaaaaaaaaaaaaaa
aaaaaaaaaaaaaaaaaaaa
aaaaaaaaaaaaaaaaaaaa
aaaaabccccccccdaaaaa
aaaaaefffghhifjaaaaa
aaaaaefffkllmfjaaaaa
aaaaaefghnllmfjaaaaa
aaaaaefkllllmfjaaaaa
aaaaaefkllllmfjaaaaa
aaaaaefoppppqfjaaaaa
aaaaaeffffffffjaaaaa
aaaaarsssssssstaaaaa
aaaaaaaaaauvwaaaaaaa
aaaaaaaaaaxyzaaaaaaa
aaaaaaAaaaBCDaaaaaaa
aaaaaaaaaaaEaaaaaaaa
aaaaaaaaaaaaaaaaaaaa
aaaaaaaaaaaaaaaaaaaa
aaaaaaaaaaaaaaaaaaaa
"}
